{
    "width" : 6,
    "depth" : 6,

    "sunlight" : [ 0, 1, 0 ],

    "altitude" : [
        1, 1, 1, 1, 1, 1,
        1, 1, 1, 1, 1, 1,
        1, 1, 0, 0, 1, 1,
        1, 1, 0, 0, 1, 1,
        2, 2, 2, 2, 2, 2,
        2, 2, 2, 2, 2, 2,
    ]
}